.........###....
.........###....
..#...C.........
..#.............
..#.............
..###......CC...
..###......CC...
..##.........C..
..C.............
..#...C.........
..#......P....#.
..............#.
##..............
##.#####C######.
##.....#####....
##..............
