.........###....
.........###....
..#.............
..#.............
..#.............
..###......##...
..###......##...
..##............
..#.............
..#.............
..#......P....#.
..............#.
##..............
##.############.
##.....#####....
##..............
