#Map SIZE
SIZE 16;
#Map
MAP;
.........###....
.........###....
.........###....
..#.............
..#.............
..##............
..###......##...
..###......##...
..##............
..#.............
..#.............
..#......P....#.
..............#.
##..............
##.############.
##.....#####....
##..............
END_MAP;